..##.S...T
#.##..###.
#.###E###E
#E..E.###.
#.#T#####.
..##.....T
#.....###.
#.###E###E
#E..E.###.
#.#T######
..##.....T
#.##..###.
#.###E###E
#E..E.###.
###T#####G
