.S##.....T
#G##..###.
#.###E###E
#E..E.###.
###T#####G
