.S##.T...T
#T##..###.
#.###E###E
#E..ET###.
###T#####G
